NO ./textures/horror1.xpm
WE ./textures/horror2.xpm

F 30,10,10
EA ./textures/horror3.xpm
C 20,20,50     	
    
       
     
SO ./textures/horror4.xpm


                   
111111111111111111111111111111111111111111111111111
1S1000001000100000001000000010000000101000000000001
101110101110101011111010101110111010101011101111111
100000101000101000000010101000101010001000100000001
111111101011101111111110111011101011101110111111101
101000001000100000100010000000001000100010100000101
101011111110111110111011111111111110111110111110101
101010001000000010001000000010000000100010100000101
101010101011111011101110111010111111101010101111101
100010100010001000100010001010001000101010100010001
101110111110101110111011101111101010101010111010101
100010100000100010001000001000100010101010100010101
111010101111111010111111101010111010101010101010111
100010001000001010100000001010001010001010001010001
101110111011101010101111111011101110111011111011101
101000001000101010100000100010100010001000000000101
101111111110101011111110101110111011101111111111101
100010001000101000001000101000001000100000001000001
111010101011101110111011101011101110111111111011101
101000100010100010000010001000100010000000001000101
101111111110111010111110111111101011111111101110111
100010000010000010100010001000001000001000100010001
101110111010111110111011101011111111101010111010101
100000100010100010000000101000000000101010001010101
101111101010101111111110101111111110101011101011101
101000101010101000001000100000000010101010001000001
111010101010101010111011111111111010101011111111101
100010001010100010000000100000000010101010000000101
101111111010101111111111101111111110101010101111101
101000000010101010001000001000000000100010100000101
101111111010101010101011111111101110111010111110101
101000001010100010101000000000100010001010100010101
101011101010101110101011111110111011101110111010101
101010001010101000101000100000100010101000100010001
101010111010111011101111101111111010101011101111111
100010001010001010100000100010001000101010000000001
101111101011101010111110111010101110101011111111101
101000101000100010000010001010100010100010000000101
111010101110111110111011101010111010111110111110101
100010100010100000101000101000101010000000101000101
101110111010101111101110101011101011111111101011101
100010000010100000000010101000101010000000001000001
101011111111111111111010101110101011101010111111101
101000100000000000001010101000001000101010100000001
101110101111101011111010101111101110101010101111111
101000100010001010001010100000101000101010101000001
111010111010111110101010111110101011111011101111101
100010001010000000101010000010101010000010001000001
101111111011111111101011101110111010101110111011101
100000000000000000100000100000000010100000000010001
111111111111111111111111111111111111111111111111111
                                                  
                                                  
                                                                                     
                                                  
                                                  