NO ./textures/north.xpm
WE ./textures/west.xpm

F 66,55,44
EA ./textures/east.xpm
C 0,99,240     	
    
       
     
SO ./textures/south.xpm


                   
                                                                                                                                                      
 1111111111111111111111111111                         
10000000000000000000000011111111111111111         
1000000000000000000000000000000000000000111       
1000000000000000001111111110000000000000001       
1000000000000000011000000011111100000000001       
1000000000000000010000000000000111000000001       
1111000000000000011111111110000001000000001       
    111111000000000000000010000001000000001       
         1110000000000000010000010000000001       
          110000000000000010000010000000001       
       111000000010000000010000010000000001       
       100000000001100000010000010000000001       
       110000000000111000011111111111111111       
        1100000000000110001                       
         111000000000010001                       
           1100000000011001                       
             11110000001001                       
                11111101001111111111111111        
                    1101100000000000000011        
                    100010000000000000011         
              11111110000000000000000011          
             110000000000N0000000000011           
             1000000000000000000000011            
            1000000000000000010100011             
          11000000000000001001001001              
          10001111111111001001001011              
         1001110000000010011010100011             
     1111100100000000001000101000000111           
   1100000001000111111110000010000000011          
   100000000010010000000000000000000000111        
   100000000010010000000000000000000000001        
   10000001001001001111111000011111111111         
   10001001001001001100001000011                  
   1000100100100100011000100000011                
   10001000001001000011001000000011               
   1000100100100100000100100000000111             
  110001001001001111111101000000000011            
  10000110100100000000000100000000000111          
  1000001010010000000111111111111111111         
  1100001010011111111                             
   100000010000000001111                          
   100000000000000000000111111111111111           
   100000000000000000000000000000000001           
   100000000111111111100000000000000001           
   100000000000000000000000000000000001           
   111111000000000000000011111111000001           
         111111111111111111111111111111           
                                                  
                                                  
                                                  