NO ./textures/zlij.xpm
WE ./textures/zlij.xpm

F 210,0,33
EA ./textures/zlij.xpm
C 0,30,255     	
    
       
     
SO ./textures/zlij.xpm


                   
111111111111   
110000000001   
100000000011   
10000000011    
10000000111111111   
1000000011     
1000010001     
1110000001     
  100N00001    
  1000000011   
 11000000011   
11000000011    
1000000011     
100000111      
1111111        